11111111111111111111111111111111111111111
1E000000000000000000000000000000000000001
10000101001000001010010000000101000010001
10100100101010100010010000000101000011101
1P100000000000000C00000000000000001100111
11000000000001000010000011110010000000101
10010101000000010100111001C00000001000001
11111111111111111111111111111111111111111
