1111111111111
1P000000000C1
1011110111101
1001110111001
100000E0000C1
1001110111001
1011110111101
1C0000C0000C1
1111111111111
